album - album
ale - but 
bardzo - very
bilet - ticket
co - what
co slychac - how are you?
czesc - hi!
dobrze - good
drogi - expensive
dyktafon - taperecorder
dziekuje - thank you
ile kosztuje - how much is that?
jest - be
kalendarz - calendar
kalkulator
kolega - collegue
kolezanka ; kolezanka z pracy - work collegue
koniak - cogniac 
kto
lampa
ladny - beautiful
moze - may
nie - no
do jutra - see you tomorrow
notes - notebook
piwo
poprosic
prosze pani - 
prosze pan - 
sklep - shop
spotkanie - meeting
sprzedawczyni - women who sells
szef - boss
szkola - school
tak - yes
tani - cheap
telefon 
to - this
ty - you
(nie) wiem - (don't) know
wino
w porzadku - is okay
zloty 
 dziesiec zlotych
dyskoteka
filharmonia
galeria
kino
pub
kawiarnia - coffeeshop
muzeum
restauracja - restaurant
opera
teatr
